..............................
..............................
..............................
..............................
..............................
..............................
..........................111.
..............................
111111111111111111111111111111
