..............................
..............................
..............................
..............................
..............................
..............................
......2.......2..........2....
..............................
11111111...1111111111111...111