..............................
..............................
.....................2........
..............................
..............2..........44...
......................4.......
.....2............44..........
.............444..............
44444...444................444
