..............................
..............................
..............................
..............................
..............................
.....2................2.......
..............................
.....3..1113.111.23.....3.....
11111..............1111....111
